# coding: utf-8
# 置顶词库（与系统词条重码时居前）
# 
# 编码格式：字词+Tab符+编码（用户词库本身有重码则还需后面+Tab符+权重，权重大者居前，权重数字随意）
# 
# ------------ 强调一下 ------------
# 
#   词条和编码之间的不是空格，而是Tab符，如果你不知道，就复制下面编码中的空白处
#   或者按住键盘 G 键，切换到功能键盘，使用上面的Tab键
# 
# ---------------------------------------
#
# 分号冒号编码只能放此文件才能调频，如分号做次选需删除权重，外接键盘适用
：	;
；	;	90
# 如用户词无重或和系统词条重码时居前，则无需权重（如想居于系统词条后，请把词条放到flypy_user.txt文件内）
# 虽然文本码表编辑较为方便，但不适合导入大量条目
# 置顶用户词库，下一行开始添加，部署后生效

# 全码词
即可	jike
知道	vidc
只能	ving
简单	jmdj
计算	jisr
一下	yixx
一直	yivi
只是	viui
按时	anui
而是	erui
成为	igww
小时	xnui
简直	jmvi
任务	rfwu
时间	uijm
水平	uvpk
试试	uiui
神似	ufsi
传统	irts
台湾	tdwj
反应	fjyk
每周	mwvz
联系	lmxi
现金	xmjb
期间	qijm
极其	jiqi
在线	zdxm
只会	vihv
一片	yipm
美丽	mwli
几位	jiww